{
  "name": "Cambridgeshire Demo Farm (Publicly Inspired Synthetic)",
  "cell_size_m": 1.0,
  "ascii": [
    "############################",
    "#............#.............#",
    "#............#.............#",
    "#............#.............#",
    "#..........................#",
    "######.##################..#",
    "#............#............##",
    "#............#.............#",
    "#............#.............#",
    "#.....################.....#",
    "#..........................#",
    "#..........................#",
    "############################"
  ]
}
